111111111111111111111111111111111111111111111111111111111111114200000311111111111111111111111111111111111111111111111111111111111111111111111111
111111111111111111111111111111111111111400001111111111221111111111001111111111001111111111031111111111011111111111011111111111311111111111111111
111111111111111111111111111111111111111111001111114200001111111111101111111111101111111001100111111000000111111011111111111311111111111111111111
111110011111111114000001111100011001033101011011000002001211100101000011111100011211111111111001111130000001111111111111111111111111111111111111
111111111111111111111111111111111111110011111111100000011111103312011111111002011111111114011111111111111111111111111111111111111111111111111111
111111111111111111111111111111111111111100311111111021311111111000011111111101001111111120401111111100011111111111111111111111111111111111111111
111111111111111111111111111111111111111111031111111111001111111102200111111100000111111112101111111113431111111111111111111111111111111111111111
111111111111111111111111111111111111111333341111110020120111110020020111110011000111111111111111111111111111111111111111111111111111111111111111
111111111111111114001111111302031111111002011111111101111111110200111111100000111111130011111111111111111111111111111111111111111111111111111111
111111111111111111111111111111001111110003321111110241020111111233000111111001100111111111111111111111111111111111111111111111111111111111111111
111111111111111111111111111111111111110011111111110300311111110301011111110020011111111221111111111041111111111111111111111111111111111111111111
111111111111111111111111111111111111111110011111111110011111111002220111111033310111111013330111111022241111111110001111111111111111111111111111
111111111111111111111111111111111111111111111111111111031111111111033011111100200311111100010111111112220111111110411111111111111111111111111111
111111111111111111111111111100111111111102011111111032311111111023201111111032301111111114111111111100111111111100111111111100111111111111111111
111111111111111111111111111111111111111000111111103232400111100232300111111010111111111000111111111111111111111111111111111111111111111111111111
111111111111111111111111111111111111111100111111111130111111111030111111111232111111114232001111110230001111111100111111111111111111111111111111
111111111111111111111111111111111111111110001111111110521111111105450011111103500011111110001111111110011111111111111111111111111111111111111111
111111111111111111111111111111111111111104311111111022501111111001301111111000001111111021001111111100311111111111111111111111111111111111111111
111111111111111111111111111110011111110002001111110055501111110030301111111050500111111155500111111102011111111104011111111111111111111111111111
111111111111111111111111111111111111100011100111102000004111112555552111102333332011100010000011111111110011111111111111111111111111111111111111
111111111111111111111111111111111111110041111111102020202011101101101011100030003311111101131111111100001111111111111111111111111111111111111111
######################     #   #  $    #    $      ##.### ###$###.###$ #  ..   ##@ #   # #$##      # $ ..   ####################################