############
##   #######
#   @     ##
# ## ## # ##
#   *   **##
#### ##*####
####    ####
############

